date,year,month,day,total_confirmed_cases,prev_day_confirmed,daily_confirmed
2020-01-23,2020,1,23,1,0,1
2020-01-24,2020,1,24,3,1,2
2020-01-25,2020,1,25,3,3,0
2020-01-26,2020,1,26,4,3,1
2020-01-27,2020,1,27,5,4,1
2020-01-28,2020,1,28,7,5,2
2020-01-29,2020,1,29,7,7,0
2020-01-30,2020,1,30,10,7,3
2020-01-31,2020,1,31,13,10,3
2020-02-01,2020,2,1,16,13,3
2020-02-02,2020,2,2,18,16,2
2020-02-03,2020,2,3,18,18,0
2020-02-04,2020,2,4,24,18,6
2020-02-05,2020,2,5,28,24,4
2020-02-06,2020,2,6,28,28,0
2020-02-07,2020,2,7,30,28,2
2020-02-08,2020,2,8,33,30,3
2020-02-09,2020,2,9,40,33,7
2020-02-10,2020,2,10,45,40,5
2020-02-11,2020,2,11,47,45,2
2020-02-12,2020,2,12,50,47,3
2020-02-13,2020,2,13,58,50,8
2020-02-14,2020,2,14,67,58,9
2020-02-15,2020,2,15,72,67,5
2020-02-16,2020,2,16,75,72,3
2020-02-17,2020,2,17,77,75,2
2020-02-18,2020,2,18,81,77,4
2020-02-19,2020,2,19,84,81,3
2020-02-20,2020,2,20,84,84,0
2020-02-21,2020,2,21,85,84,1
2020-02-22,2020,2,22,85,85,0
2020-02-23,2020,2,23,89,85,4
2020-02-24,2020,2,24,89,89,0
2020-02-25,2020,2,25,91,89,2
2020-02-26,2020,2,26,93,91,2
2020-02-27,2020,2,27,93,93,0
2020-02-28,2020,2,28,93,93,0
2020-02-29,2020,2,29,102,93,9
2020-03-01,2020,3,1,106,102,4
2020-03-02,2020,3,2,108,106,2
2020-03-03,2020,3,3,110,108,2
2020-03-04,2020,3,4,110,110,0
2020-03-05,2020,3,5,117,110,7
2020-03-06,2020,3,6,130,117,13
2020-03-07,2020,3,7,138,130,8
2020-03-08,2020,3,8,150,138,12
2020-03-09,2020,3,9,150,150,0
2020-03-10,2020,3,10,160,150,10
2020-03-11,2020,3,11,178,160,18
2020-03-12,2020,3,12,178,178,0
2020-03-13,2020,3,13,200,178,22
2020-03-14,2020,3,14,212,200,12
2020-03-15,2020,3,15,226,212,14
2020-03-16,2020,3,16,243,226,17
2020-03-17,2020,3,17,266,243,23
2020-03-18,2020,3,18,313,266,47
2020-03-19,2020,3,19,345,313,32
2020-03-20,2020,3,20,385,345,40
2020-03-21,2020,3,21,432,385,47
2020-03-22,2020,3,22,455,432,23
2020-03-23,2020,3,23,509,455,54
2020-03-24,2020,3,24,558,509,49
2020-03-25,2020,3,25,631,558,73
2020-03-26,2020,3,26,683,631,52
2020-03-27,2020,3,27,732,683,49
2020-03-28,2020,3,28,802,732,70
2020-03-29,2020,3,29,844,802,42
2020-03-30,2020,3,30,879,844,35
2020-03-31,2020,3,31,926,879,47
2020-04-01,2020,4,1,1000,926,74
2020-04-02,2020,4,2,1049,1000,49
2020-04-03,2020,4,3,1114,1049,65
2020-04-04,2020,4,4,1189,1114,75
2020-04-05,2020,4,5,1309,1189,120
2020-04-06,2020,4,6,1375,1309,66
2020-04-07,2020,4,7,1481,1375,106
2020-04-08,2020,4,8,1623,1481,142
2020-04-09,2020,4,9,1910,1623,287
2020-04-10,2020,4,10,2108,1910,198
2020-04-11,2020,4,11,2299,2108,191
2020-04-12,2020,4,12,2532,2299,233
2020-04-13,2020,4,13,2918,2532,386
2020-04-14,2020,4,14,3252,2918,334
2020-04-15,2020,4,15,3699,3252,447
2020-04-16,2020,4,16,4427,3699,728
2020-04-17,2020,4,17,5050,4427,623
2020-04-18,2020,4,18,5992,5050,942
2020-04-19,2020,4,19,6588,5992,596
2020-04-20,2020,4,20,8014,6588,1426
2020-04-21,2020,4,21,9125,8014,1111
2020-04-22,2020,4,22,10141,9125,1016
2020-04-23,2020,4,23,11178,10141,1037
2020-04-24,2020,4,24,12075,11178,897
2020-04-25,2020,4,25,12693,12075,618
2020-04-26,2020,4,26,13624,12693,931
2020-04-27,2020,4,27,14423,13624,799
2020-04-28,2020,4,28,14951,14423,528
2020-04-29,2020,4,29,15641,14951,690
2020-04-30,2020,4,30,16169,15641,528
2020-05-01,2020,5,1,17101,16169,932
2020-05-02,2020,5,2,17548,17101,447
2020-05-03,2020,5,3,18205,17548,657
2020-05-04,2020,5,4,18778,18205,573
2020-05-05,2020,5,5,19410,18778,632
2020-05-06,2020,5,6,20198,19410,788
2020-05-07,2020,5,7,20939,20198,741
2020-05-08,2020,5,8,21707,20939,768
2020-05-09,2020,5,9,22460,21707,753
2020-05-10,2020,5,10,23336,22460,876
2020-05-11,2020,5,11,23822,23336,486
2020-05-12,2020,5,12,24671,23822,849
2020-05-13,2020,5,13,25346,24671,675
2020-05-14,2020,5,14,26098,25346,752
2020-05-15,2020,5,15,26891,26098,793
2020-05-16,2020,5,16,27356,26891,465
2020-05-17,2020,5,17,28038,27356,682
2020-05-18,2020,5,18,28343,28038,305
2020-05-19,2020,5,19,28794,28343,451
2020-05-20,2020,5,20,29364,28794,570
2020-05-21,2020,5,21,29812,29364,448
2020-05-22,2020,5,22,30426,29812,614
2020-05-23,2020,5,23,31068,30426,642
2020-05-24,2020,5,24,31616,31068,548
2020-05-25,2020,5,25,31960,31616,344
2020-05-26,2020,5,26,32343,31960,383
2020-05-27,2020,5,27,32876,32343,533
2020-05-28,2020,5,28,33249,32876,373
2020-05-29,2020,5,29,33860,33249,611
2020-05-30,2020,5,30,34366,33860,506
2020-05-31,2020,5,31,34884,34366,518
2020-06-01,2020,6,1,35292,34884,408
2020-06-02,2020,6,2,35836,35292,544
2020-06-03,2020,6,3,36405,35836,569
2020-06-04,2020,6,4,36922,36405,517
2020-06-05,2020,6,5,37183,36922,261
2020-06-06,2020,6,6,37527,37183,344
2020-06-07,2020,6,7,37910,37527,383
2020-06-08,2020,6,8,38296,37910,386
2020-06-09,2020,6,9,38514,38296,218
2020-06-10,2020,6,10,38965,38514,451
2020-06-11,2020,6,11,39387,38965,422
2020-06-12,2020,6,12,39850,39387,463
2020-06-13,2020,6,13,40197,39850,347
2020-06-14,2020,6,14,40604,40197,407
2020-06-15,2020,6,15,40818,40604,214
2020-06-16,2020,6,16,40969,40818,151
2020-06-17,2020,6,17,41216,40969,247
2020-06-18,2020,6,18,41473,41216,257
2020-06-19,2020,6,19,41615,41473,142
2020-06-20,2020,6,20,41833,41615,218
2020-06-21,2020,6,21,42095,41833,262
2020-06-22,2020,6,22,42313,42095,218
2020-06-23,2020,6,23,42432,42313,119
2020-06-24,2020,6,24,42623,42432,191
2020-06-25,2020,6,25,42736,42623,113
2020-06-26,2020,6,26,42955,42736,219
2020-06-27,2020,6,27,43246,42955,291
2020-06-28,2020,6,28,43459,43246,213
2020-06-29,2020,6,29,43661,43459,202
2020-06-30,2020,6,30,43907,43661,246
2020-07-01,2020,7,1,44122,43907,215
2020-07-02,2020,7,2,44310,44122,188
2020-07-03,2020,7,3,44479,44310,169
2020-07-04,2020,7,4,44664,44479,185
2020-07-05,2020,7,5,44800,44664,136
2020-07-06,2020,7,6,44983,44800,183
2020-07-07,2020,7,7,45140,44983,157
2020-07-08,2020,7,8,45298,45140,158
2020-07-09,2020,7,9,45423,45298,125
2020-07-10,2020,7,10,45614,45423,191
2020-07-11,2020,7,11,45783,45614,169
2020-07-12,2020,7,12,45961,45783,178
2020-07-13,2020,7,13,46283,45961,322
2020-07-14,2020,7,14,46630,46283,347
2020-07-15,2020,7,15,46878,46630,248
2020-07-16,2020,7,16,47126,46878,248
2020-07-17,2020,7,17,47453,47126,327
2020-07-18,2020,7,18,47655,47453,202
2020-07-19,2020,7,19,47912,47655,257
2020-07-20,2020,7,20,48035,47912,123
2020-07-21,2020,7,21,48434,48035,399
2020-07-22,2020,7,22,48744,48434,310
2020-07-23,2020,7,23,49098,48744,354
2020-07-24,2020,7,24,49375,49098,277
2020-07-25,2020,7,25,49888,49375,513
2020-07-26,2020,7,26,50369,49888,481
2020-07-27,2020,7,27,50838,50369,469
2020-07-28,2020,7,28,51197,50838,359
2020-07-29,2020,7,29,51531,51197,334
2020-07-30,2020,7,30,51809,51531,278
2020-07-31,2020,7,31,52205,51809,396
2020-08-01,2020,8,1,52512,52205,307
2020-08-02,2020,8,2,52825,52512,313
2020-08-03,2020,8,3,53051,52825,226
2020-08-04,2020,8,4,53346,53051,295
2020-08-05,2020,8,5,54254,53346,908
2020-08-06,2020,8,6,54555,54254,301
2020-08-07,2020,8,7,54797,54555,242
2020-08-08,2020,8,8,54929,54797,132
2020-08-09,2020,8,9,55104,54929,175
2020-08-10,2020,8,10,55292,55104,188
2020-08-11,2020,8,11,55353,55292,61
2020-08-12,2020,8,12,55395,55353,42
2020-08-13,2020,8,13,55497,55395,102
2020-08-14,2020,8,14,55580,55497,83
2020-08-15,2020,8,15,55661,55580,81
2020-08-16,2020,8,16,55747,55661,86
2020-08-17,2020,8,17,55838,55747,91
2020-08-18,2020,8,18,55938,55838,100
2020-08-19,2020,8,19,56031,55938,93
2020-08-20,2020,8,20,56099,56031,68
2020-08-21,2020,8,21,56216,56099,117
2020-08-22,2020,8,22,56266,56216,50
2020-08-23,2020,8,23,56353,56266,87
2020-08-24,2020,8,24,56404,56353,51
2020-08-25,2020,8,25,56435,56404,31
2020-08-26,2020,8,26,56495,56435,60
2020-08-27,2020,8,27,56572,56495,77
2020-08-28,2020,8,28,56666,56572,94
2020-08-29,2020,8,29,56717,56666,51
2020-08-30,2020,8,30,56771,56717,54
2020-08-31,2020,8,31,56812,56771,41
2020-09-01,2020,9,1,56852,56812,40
2020-09-02,2020,9,2,56860,56852,8
2020-09-03,2020,9,3,56908,56860,48
2020-09-04,2020,9,4,56948,56908,40
2020-09-05,2020,9,5,56982,56948,34
2020-09-06,2020,9,6,57022,56982,40
2020-09-07,2020,9,7,57044,57022,22
2020-09-08,2020,9,8,57091,57044,47
2020-09-09,2020,9,9,57166,57091,75
2020-09-10,2020,9,10,57229,57166,63
2020-09-11,2020,9,11,57315,57229,86
2020-09-12,2020,9,12,57357,57315,42
2020-09-13,2020,9,13,57406,57357,49
2020-09-14,2020,9,14,57454,57406,48
2020-09-15,2020,9,15,57488,57454,34
2020-09-16,2020,9,16,57514,57488,26
2020-09-17,2020,9,17,57532,57514,18
2020-09-18,2020,9,18,57543,57532,11
2020-09-19,2020,9,19,57558,57543,15
2020-09-20,2020,9,20,57576,57558,18
2020-09-21,2020,9,21,57606,57576,30
2020-09-22,2020,9,22,57627,57606,21
2020-09-23,2020,9,23,57639,57627,12
2020-09-24,2020,9,24,57654,57639,15
2020-09-25,2020,9,25,57665,57654,11
2020-09-26,2020,9,26,57685,57665,20
2020-09-27,2020,9,27,57700,57685,15
2020-09-28,2020,9,28,57715,57700,15
2020-09-29,2020,9,29,57742,57715,27
2020-09-30,2020,9,30,57765,57742,23
2020-10-01,2020,10,1,57784,57765,19
2020-10-02,2020,10,2,57794,57784,10
2020-10-03,2020,10,3,57800,57794,6
2020-10-04,2020,10,4,57812,57800,12
2020-10-05,2020,10,5,57819,57812,7
2020-10-06,2020,10,6,57830,57819,11
2020-10-07,2020,10,7,57840,57830,10
2020-10-08,2020,10,8,57849,57840,9
2020-10-09,2020,10,9,57859,57849,10
2020-10-10,2020,10,10,57866,57859,7
2020-10-11,2020,10,11,57876,57866,10
2020-10-12,2020,10,12,57880,57876,4
2020-10-13,2020,10,13,57884,57880,4
2020-10-14,2020,10,14,57889,57884,5
2020-10-15,2020,10,15,57892,57889,3
2020-10-16,2020,10,16,57901,57892,9
2020-10-17,2020,10,17,57904,57901,3
2020-10-18,2020,10,18,57911,57904,7
2020-10-19,2020,10,19,57915,57911,4
2020-10-20,2020,10,20,57921,57915,6
2020-10-21,2020,10,21,57933,57921,12
2020-10-22,2020,10,22,57941,57933,8
2020-10-23,2020,10,23,57951,57941,10
2020-10-24,2020,10,24,57965,57951,14
2020-10-25,2020,10,25,57970,57965,5
2020-10-26,2020,10,26,57973,57970,3
2020-10-27,2020,10,27,57980,57973,7
2020-10-28,2020,10,28,57987,57980,7
2020-10-29,2020,10,29,57994,57987,7
2020-10-30,2020,10,30,58003,57994,9
2020-10-31,2020,10,31,58015,58003,12
2020-11-01,2020,11,1,58019,58015,4
2020-11-02,2020,11,2,58020,58019,1
2020-11-03,2020,11,3,58029,58020,9
2020-11-04,2020,11,4,58036,58029,7
2020-11-05,2020,11,5,58043,58036,7
2020-11-06,2020,11,6,58047,58043,4
2020-11-07,2020,11,7,58054,58047,7
2020-11-08,2020,11,8,58056,58054,2
2020-11-09,2020,11,9,58064,58056,8
2020-11-10,2020,11,10,58073,58064,9
2020-11-11,2020,11,11,58091,58073,18
2020-11-12,2020,11,12,58102,58091,11
2020-11-13,2020,11,13,58114,58102,12
2020-11-14,2020,11,14,58116,58114,2
2020-11-15,2020,11,15,58119,58116,3
2020-11-16,2020,11,16,58124,58119,5
2020-11-17,2020,11,17,58130,58124,6
2020-11-18,2020,11,18,58135,58130,5
2020-11-19,2020,11,19,58139,58135,4
2020-11-20,2020,11,20,58143,58139,4
2020-11-21,2020,11,21,58148,58143,5
2020-11-22,2020,11,22,58160,58148,12
2020-11-23,2020,11,23,58165,58160,5
2020-11-24,2020,11,24,58183,58165,18
2020-11-25,2020,11,25,58190,58183,7
2020-11-26,2020,11,26,58195,58190,5
2020-11-27,2020,11,27,58199,58195,4
2020-11-28,2020,11,28,58205,58199,6
2020-11-29,2020,11,29,58213,58205,8
2020-11-30,2020,11,30,58218,58213,5
2020-12-01,2020,12,1,58228,58218,10
2020-12-02,2020,12,2,58230,58228,2
2020-12-03,2020,12,3,58239,58230,9
2020-12-04,2020,12,4,58242,58239,3
2020-12-05,2020,12,5,58255,58242,13
2020-12-06,2020,12,6,58260,58255,5
2020-12-07,2020,12,7,58273,58260,13
2020-12-08,2020,12,8,58285,58273,12
2020-12-09,2020,12,9,58291,58285,6
2020-12-10,2020,12,10,58297,58291,6
2020-12-11,2020,12,11,58305,58297,8
2020-12-12,2020,12,12,58313,58305,8
2020-12-13,2020,12,13,58320,58313,7
2020-12-14,2020,12,14,58325,58320,5
2020-12-15,2020,12,15,58341,58325,16
2020-12-16,2020,12,16,58353,58341,12
2020-12-17,2020,12,17,58377,58353,24
2020-12-18,2020,12,18,58386,58377,9
2020-12-19,2020,12,19,58403,58386,17
2020-12-20,2020,12,20,58422,58403,19
2020-12-21,2020,12,21,58432,58422,10
2020-12-22,2020,12,22,58461,58432,29
2020-12-23,2020,12,23,58482,58461,21
2020-12-24,2020,12,24,58495,58482,13
2020-12-25,2020,12,25,58509,58495,14
2020-12-26,2020,12,26,58519,58509,10
2020-12-27,2020,12,27,58524,58519,5
2020-12-28,2020,12,28,58529,58524,5
2020-12-29,2020,12,29,58542,58529,13
2020-12-30,2020,12,30,58569,58542,27
2020-12-31,2020,12,31,58599,58569,30
2021-01-01,2021,1,1,58629,58599,30
2021-01-02,2021,1,2,58662,58629,33
2021-01-03,2021,1,3,58697,58662,35
2021-01-04,2021,1,4,58721,58697,24
2021-01-05,2021,1,5,58749,58721,28
2021-01-06,2021,1,6,58780,58749,31
2021-01-07,2021,1,7,58813,58780,33
2021-01-08,2021,1,8,58836,58813,23
2021-01-09,2021,1,9,58865,58836,29
2021-01-10,2021,1,10,58907,58865,42
2021-01-11,2021,1,11,58929,58907,22
2021-01-12,2021,1,12,58946,58929,17
2021-01-13,2021,1,13,58984,58946,38
2021-01-14,2021,1,14,59029,58984,45
2021-01-15,2021,1,15,59059,59029,30
2021-01-16,2021,1,16,59083,59059,24
2021-01-17,2021,1,17,59113,59083,30
2021-01-18,2021,1,18,59127,59113,14
2021-01-19,2021,1,19,59157,59127,30
2021-01-20,2021,1,20,59197,59157,40
2021-01-21,2021,1,21,59235,59197,38
2021-01-22,2021,1,22,59250,59235,15
2021-01-23,2021,1,23,59260,59250,10
2021-01-24,2021,1,24,59308,59260,48
2021-01-25,2021,1,25,59352,59308,44
2021-01-26,2021,1,26,59366,59352,14
2021-01-27,2021,1,27,59391,59366,25
2021-01-28,2021,1,28,59425,59391,34
2021-01-29,2021,1,29,59449,59425,24
2021-01-30,2021,1,30,59507,59449,58
2021-01-31,2021,1,31,59536,59507,29
2021-02-01,2021,2,1,59565,59536,29
2021-02-02,2021,2,2,59584,59565,19
2021-02-03,2021,2,3,59602,59584,18
2021-02-04,2021,2,4,59624,59602,22
2021-02-05,2021,2,5,59649,59624,25
2021-02-06,2021,2,6,59675,59649,26
2021-02-07,2021,2,7,59699,59675,24
2021-02-08,2021,2,8,59721,59699,22
2021-02-09,2021,2,9,59732,59721,11
2021-02-10,2021,2,10,59747,59732,15
2021-02-11,2021,2,11,59759,59747,12
2021-02-12,2021,2,12,59777,59759,18
2021-02-13,2021,2,13,59786,59777,9
2021-02-14,2021,2,14,59800,59786,14
2021-02-15,2021,2,15,59809,59800,9
2021-02-16,2021,2,16,59810,59809,1
2021-02-17,2021,2,17,59821,59810,11
2021-02-18,2021,2,18,59832,59821,11
2021-02-19,2021,2,19,59846,59832,14
2021-02-20,2021,2,20,59858,59846,12
2021-02-21,2021,2,21,59869,59858,11
2021-02-22,2021,2,22,59879,59869,10
2021-02-23,2021,2,23,59883,59879,4
2021-02-24,2021,2,24,59890,59883,7
2021-02-25,2021,2,25,59900,59890,10
2021-02-26,2021,2,26,59913,59900,13
2021-02-27,2021,2,27,59925,59913,12
2021-02-28,2021,2,28,59936,59925,11
2021-03-01,2021,3,1,59948,59936,12
2021-03-02,2021,3,2,59956,59948,8
2021-03-03,2021,3,3,59979,59956,23
2021-03-04,2021,3,4,59998,59979,19
2021-03-05,2021,3,5,60007,59998,9
2021-03-06,2021,3,6,60020,60007,13
2021-03-07,2021,3,7,60033,60020,13
2021-03-08,2021,3,8,60046,60033,13
2021-03-09,2021,3,9,60052,60046,6
2021-03-10,2021,3,10,60062,60052,10
2021-03-11,2021,3,11,60070,60062,8
2021-03-12,2021,3,12,60080,60070,10
2021-03-13,2021,3,13,60088,60080,8
2021-03-14,2021,3,14,60105,60088,17
2021-03-15,2021,3,15,60117,60105,12
2021-03-16,2021,3,16,60128,60117,11
2021-03-17,2021,3,17,60137,60128,9
2021-03-18,2021,3,18,60152,60137,15
2021-03-19,2021,3,19,60167,60152,15
2021-03-20,2021,3,20,60184,60167,17
2021-03-21,2021,3,21,60196,60184,12
2021-03-22,2021,3,22,60208,60196,12
2021-03-23,2021,3,23,60221,60208,13
2021-03-24,2021,3,24,60236,60221,15
2021-03-25,2021,3,25,60253,60236,17
2021-03-26,2021,3,26,60265,60253,12
2021-03-27,2021,3,27,60288,60265,23
2021-03-28,2021,3,28,60300,60288,12
2021-03-29,2021,3,29,60321,60300,21
2021-03-30,2021,3,30,60347,60321,26
2021-03-31,2021,3,31,60381,60347,34
2021-04-01,2021,4,1,60407,60381,26
2021-04-02,2021,4,2,60450,60407,43
2021-04-03,2021,4,3,60468,60450,18
2021-04-04,2021,4,4,60478,60468,10
2021-04-05,2021,4,5,60495,60478,17
2021-04-06,2021,4,6,60519,60495,24
2021-04-07,2021,4,7,60554,60519,35
2021-04-08,2021,4,8,60575,60554,21
2021-04-09,2021,4,9,60601,60575,26
2021-04-10,2021,4,10,60633,60601,32
2021-04-11,2021,4,11,60653,60633,20
2021-04-12,2021,4,12,60678,60653,25
2021-04-13,2021,4,13,60692,60678,14
2021-04-14,2021,4,14,60719,60692,27
2021-04-15,2021,4,15,60735,60719,16
2021-04-16,2021,4,16,60769,60735,34
2021-04-17,2021,4,17,60808,60769,39
2021-04-18,2021,4,18,60831,60808,23
2021-04-19,2021,4,19,60851,60831,20
2021-04-20,2021,4,20,60865,60851,14
2021-04-21,2021,4,21,60880,60865,15
2021-04-22,2021,4,22,60904,60880,24
2021-04-23,2021,4,23,60943,60904,39
2021-04-24,2021,4,24,60966,60943,23
2021-04-25,2021,4,25,61006,60966,40
2021-04-26,2021,4,26,61051,61006,45
2021-04-27,2021,4,27,61063,61051,12
2021-04-28,2021,4,28,61086,61063,23
2021-04-29,2021,4,29,61121,61086,35
2021-04-30,2021,4,30,61145,61121,24
2021-05-01,2021,5,1,61179,61145,34
2021-05-02,2021,5,2,61218,61179,39
2021-05-03,2021,5,3,61235,61218,17
2021-05-04,2021,5,4,61252,61235,17
2021-05-05,2021,5,5,61268,61252,16
2021-05-06,2021,5,6,61286,61268,18
2021-05-07,2021,5,7,61311,61286,25
2021-05-08,2021,5,8,61331,61311,20
2021-05-09,2021,5,9,61359,61331,28
2021-05-10,2021,5,10,61378,61359,19
2021-05-11,2021,5,11,61403,61378,25
2021-05-12,2021,5,12,61419,61403,16
2021-05-13,2021,5,13,61453,61419,34
2021-05-14,2021,5,14,61505,61453,52
2021-05-15,2021,5,15,61536,61505,31
2021-05-16,2021,5,16,61585,61536,49
2021-05-17,2021,5,17,61613,61585,28
2021-05-18,2021,5,18,61651,61613,38
2021-05-19,2021,5,19,61689,61651,38
2021-05-20,2021,5,20,61730,61689,41
2021-05-21,2021,5,21,61770,61730,40
2021-05-22,2021,5,22,61799,61770,29
2021-05-23,2021,5,23,61824,61799,25
2021-05-24,2021,5,24,61860,61824,36
2021-05-25,2021,5,25,61890,61860,30
2021-05-26,2021,5,26,61916,61890,26
2021-05-27,2021,5,27,61940,61916,24
2021-05-28,2021,5,28,61970,61940,30
2021-05-29,2021,5,29,62003,61970,33
2021-05-30,2021,5,30,62028,62003,25
2021-05-31,2021,5,31,62051,62028,23
2021-06-01,2021,6,1,62069,62051,18
2021-06-02,2021,6,2,62100,62069,31
2021-06-03,2021,6,3,62145,62100,45
2021-06-04,2021,6,4,62158,62145,13
2021-06-05,2021,6,5,62176,62158,18
2021-06-06,2021,6,6,62196,62176,20
2021-06-07,2021,6,7,62210,62196,14
2021-06-08,2021,6,8,62219,62210,9
2021-06-09,2021,6,9,62223,62219,4
2021-06-10,2021,6,10,62236,62223,13
2021-06-11,2021,6,11,62245,62236,9
2021-06-12,2021,6,12,62263,62245,18
2021-06-13,2021,6,13,62276,62263,13
2021-06-14,2021,6,14,62301,62276,25
2021-06-15,2021,6,15,62315,62301,14
2021-06-16,2021,6,16,62339,62315,24
2021-06-17,2021,6,17,62366,62339,27
2021-06-18,2021,6,18,62382,62366,16
2021-06-19,2021,6,19,62403,62382,21
2021-06-20,2021,6,20,62414,62403,11
2021-06-21,2021,6,21,62430,62414,16
2021-06-22,2021,6,22,62448,62430,18
2021-06-23,2021,6,23,62470,62448,22
2021-06-24,2021,6,24,62493,62470,23
2021-06-25,2021,6,25,62513,62493,20
2021-06-26,2021,6,26,62530,62513,17
2021-06-27,2021,6,27,62544,62530,14
2021-06-28,2021,6,28,62553,62544,9
2021-06-29,2021,6,29,62563,62553,10
2021-06-30,2021,6,30,62579,62563,16
2021-07-01,2021,7,1,62589,62579,10
2021-07-02,2021,7,2,62599,62589,10
2021-07-03,2021,7,3,62606,62599,7
2021-07-04,2021,7,4,62617,62606,11
2021-07-05,2021,7,5,62630,62617,13
2021-07-06,2021,7,6,62640,62630,10
2021-07-07,2021,7,7,62652,62640,12
2021-07-08,2021,7,8,62668,62652,16
2021-07-09,2021,7,9,62678,62668,10
2021-07-10,2021,7,10,62684,62678,6
2021-07-11,2021,7,11,62692,62684,8
2021-07-12,2021,7,12,62718,62692,26
2021-07-13,2021,7,13,62744,62718,26
2021-07-14,2021,7,14,62804,62744,60
2021-07-15,2021,7,15,62852,62804,48
2021-07-16,2021,7,16,62913,62852,61
2021-07-17,2021,7,17,62981,62913,68
2021-07-18,2021,7,18,63073,62981,92
2021-07-19,2021,7,19,63245,63073,172
2021-07-20,2021,7,20,63440,63245,195
2021-07-21,2021,7,21,63621,63440,181
2021-07-22,2021,7,22,63791,63621,170
2021-07-23,2021,7,23,63924,63791,133
2021-07-24,2021,7,24,64054,63924,130
2021-07-25,2021,7,25,64179,64054,125
2021-07-26,2021,7,26,64314,64179,135
2021-07-27,2021,7,27,64453,64314,139
2021-07-28,2021,7,28,64589,64453,136
2021-07-29,2021,7,29,64722,64589,133
2021-07-30,2021,7,30,64861,64722,139
2021-07-31,2021,7,31,64981,64861,120
2021-08-01,2021,8,1,65102,64981,121
2021-08-02,2021,8,2,65213,65102,111
2021-08-03,2021,8,3,65315,65213,102
2021-08-04,2021,8,4,65410,65315,95
2021-08-05,2021,8,5,65508,65410,98
2021-08-06,2021,8,6,65605,65508,97
2021-08-07,2021,8,7,65686,65605,81
2021-08-08,2021,8,8,65764,65686,78
2021-08-09,2021,8,9,65836,65764,72
2021-08-10,2021,8,10,65836,65836,0
2021-08-11,2021,8,11,65953,65836,117
2021-08-12,2021,8,12,66012,65953,59
2021-08-13,2021,8,13,66061,66012,49
2021-08-14,2021,8,14,66119,66061,58
2021-08-15,2021,8,15,66172,66119,53
2021-08-16,2021,8,16,66225,66172,53
2021-08-17,2021,8,17,66281,66225,56
2021-08-18,2021,8,18,66334,66281,53
2021-08-19,2021,8,19,66366,66334,32
2021-08-20,2021,8,20,66406,66366,40
2021-08-21,2021,8,21,66443,66406,37
2021-08-22,2021,8,22,66478,66443,35
2021-08-23,2021,8,23,66576,66478,98
2021-08-24,2021,8,24,66692,66576,116
2021-08-25,2021,8,25,66812,66692,120
2021-08-26,2021,8,26,66928,66812,116
2021-08-27,2021,8,27,66928,66928,0
2021-08-28,2021,8,28,67171,66928,243
2021-08-29,2021,8,29,67171,67171,0
2021-08-30,2021,8,30,67459,67171,288
2021-08-31,2021,8,31,67620,67459,161
2021-09-01,2021,9,1,67800,67620,180
2021-09-02,2021,9,2,67991,67800,191
2021-09-03,2021,9,3,68210,67991,219
2021-09-04,2021,9,4,68469,68210,259
2021-09-05,2021,9,5,68660,68469,191
2021-09-06,2021,9,6,68901,68660,241
2021-09-07,2021,9,7,69233,68901,332
2021-09-08,2021,9,8,69582,69233,349
2021-09-09,2021,9,9,70039,69582,457
2021-09-10,2021,9,10,70612,70039,573
2021-09-11,2021,9,11,71167,70612,555
2021-09-12,2021,9,12,71687,71167,520
2021-09-13,2021,9,13,72294,71687,607
2021-09-14,2021,9,14,73131,72294,837
2021-09-15,2021,9,15,73938,73131,807
2021-09-16,2021,9,16,74848,73938,910
2021-09-17,2021,9,17,75783,74848,935
2021-09-18,2021,9,18,76792,75783,1009
2021-09-19,2021,9,19,77804,76792,1012
2021-09-20,2021,9,20,78721,77804,917
2021-09-21,2021,9,21,79899,78721,1178
2021-09-22,2021,9,22,81356,79899,1457
2021-09-23,2021,9,23,82860,81356,1504
2021-09-24,2021,9,24,84510,82860,1650
2021-09-25,2021,9,25,85953,84510,1443
2021-09-26,2021,9,26,87892,85953,1939
2021-09-27,2021,9,27,89539,87892,1647
2021-09-28,2021,9,28,91775,89539,2236
2021-09-29,2021,9,29,94043,91775,2268
2021-09-30,2021,9,30,96521,94043,2478
2021-10-01,2021,10,1,99430,96521,2909
2021-10-02,2021,10,2,101786,99430,2356
2021-10-03,2021,10,3,103843,101786,2057
2021-10-04,2021,10,4,106318,103843,2475
2021-10-05,2021,10,5,109804,106318,3486
2021-10-06,2021,10,6,113381,109804,3577
2021-10-07,2021,10,7,116864,113381,3483
2021-10-08,2021,10,8,120454,116864,3590
2021-10-09,2021,10,9,124157,120454,3703
2021-10-10,2021,10,10,126966,124157,2809
2021-10-11,2021,10,11,129229,126966,2263
2021-10-12,2021,10,12,132205,129229,2976
2021-10-13,2021,10,13,135395,132205,3190
2021-10-14,2021,10,14,138327,135395,2932
2021-10-15,2021,10,15,141772,138327,3445
2021-10-16,2021,10,16,145120,141772,3348
2021-10-17,2021,10,17,148178,145120,3058
2021-10-18,2021,10,18,150731,148178,2553
2021-10-19,2021,10,19,154725,150731,3994
2021-10-20,2021,10,20,158587,154725,3862
2021-10-21,2021,10,21,162026,158587,3439
2021-10-22,2021,10,22,165663,162026,3637
2021-10-23,2021,10,23,169261,165663,3598
2021-10-24,2021,10,24,172644,169261,3383
2021-10-25,2021,10,25,175818,172644,3174
2021-10-26,2021,10,26,179095,175818,3277
2021-10-27,2021,10,27,184419,179095,5324
2021-10-28,2021,10,28,187851,184419,3432
2021-10-29,2021,10,29,192099,187851,4248
2021-10-30,2021,10,30,195211,192099,3112
2021-10-31,2021,10,31,198374,195211,3163
2021-11-01,2021,11,1,200844,198374,2470
2021-11-02,2021,11,2,204340,200844,3496
2021-11-03,2021,11,3,207975,204340,3635
2021-11-04,2021,11,4,210978,207975,3003
2021-11-05,2021,11,5,212745,210978,1767
2021-11-06,2021,11,6,215780,212745,3035
2021-11-07,2021,11,7,218333,215780,2553
2021-11-08,2021,11,8,220803,218333,2470
2021-11-09,2021,11,9,224200,220803,3397
2021-11-10,2021,11,10,227681,224200,3481
2021-11-11,2021,11,11,230077,227681,2396
2021-11-12,2021,11,12,233176,230077,3099
2021-11-13,2021,11,13,235480,233176,2304
2021-11-14,2021,11,14,237203,235480,1723
2021-11-15,2021,11,15,239272,237203,2069
2021-11-16,2021,11,16,241341,239272,2069
2021-11-17,2021,11,17,244815,241341,3474
2021-11-18,2021,11,18,244815,244815,0
2021-11-19,2021,11,19,248587,244815,3772
2021-11-20,2021,11,20,250518,248587,1931
2021-11-21,2021,11,21,252188,250518,1670
2021-11-22,2021,11,22,253649,252188,1461
2021-11-23,2021,11,23,255431,253649,1782
2021-11-24,2021,11,24,257510,255431,2079
2021-11-25,2021,11,25,258785,257510,1275
2021-11-26,2021,11,26,259875,258785,1090
2021-11-27,2021,11,27,261636,259875,1761
2021-11-28,2021,11,28,262383,261636,747
2021-11-29,2021,11,29,263486,262383,1103
2021-11-30,2021,11,30,264725,263486,1239
2021-12-01,2021,12,1,266049,264725,1324
2021-12-02,2021,12,2,267150,266049,1101
2021-12-03,2021,12,3,267916,267150,766
2021-12-04,2021,12,4,268659,267916,743
2021-12-05,2021,12,5,269211,268659,552
2021-12-06,2021,12,6,269873,269211,662
2021-12-07,2021,12,7,270588,269873,715
2021-12-08,2021,12,8,271297,270588,709
2021-12-09,2021,12,9,271979,271297,682
2021-12-10,2021,12,10,272433,271979,454
2021-12-11,2021,12,11,272992,272433,559
2021-12-12,2021,12,12,273362,272992,370
2021-12-13,2021,12,13,273701,273362,339
2021-12-14,2021,12,14,274143,273701,442
2021-12-15,2021,12,15,274617,274143,474
2021-12-16,2021,12,16,274972,274617,355
2021-12-17,2021,12,17,275384,274972,412
2021-12-18,2021,12,18,275655,275384,271
2021-12-19,2021,12,19,275910,275655,255
2021-12-20,2021,12,20,276105,275910,195
2021-12-21,2021,12,21,276385,276105,280
2021-12-22,2021,12,22,276720,276385,335
2021-12-23,2021,12,23,277042,276720,322
2021-12-24,2021,12,24,277307,277042,265
2021-12-25,2021,12,25,277555,277307,248
2021-12-26,2021,12,26,277764,277555,209
2021-12-27,2021,12,27,278044,277764,280
2021-12-28,2021,12,28,278409,278044,365
2021-12-29,2021,12,29,278750,278409,341
2021-12-30,2021,12,30,279061,278750,311
2021-12-31,2021,12,31,279405,279061,344
2022-01-01,2022,1,1,279861,279405,456
2022-01-02,2022,1,2,280290,279861,429
2022-01-03,2022,1,3,280754,280290,464
2022-01-04,2022,1,4,281596,280754,842
2022-01-05,2022,1,5,282401,281596,805
2022-01-06,2022,1,6,283214,282401,813
2022-01-07,2022,1,7,283214,283214,0
2022-01-08,2022,1,8,284802,283214,1588
2022-01-09,2022,1,9,285647,284802,845
2022-01-10,2022,1,10,286397,285647,750
2022-01-11,2022,1,11,287243,286397,846
2022-01-12,2022,1,12,288125,287243,882
2022-01-13,2022,1,13,289085,288125,960
2022-01-14,2022,1,14,290030,289085,945
2022-01-15,2022,1,15,290986,290030,956
2022-01-16,2022,1,16,291849,290986,863
2022-01-17,2022,1,17,293014,291849,1165
2022-01-18,2022,1,18,294462,293014,1448
2022-01-19,2022,1,19,296077,294462,1615
2022-01-20,2022,1,20,297549,296077,1472
2022-01-21,2022,1,21,307813,297549,10264
2022-01-22,2022,1,22,310276,307813,2463
2022-01-23,2022,1,23,313772,310276,3496
2022-01-24,2022,1,24,316774,313772,3002
2022-01-25,2022,1,25,322770,316774,5996
2022-01-26,2022,1,26,327602,322770,4832
2022-01-27,2022,1,27,333071,327602,5469
2022-01-28,2022,1,28,338625,333071,5554
2022-01-29,2022,1,29,343832,338625,5207
2022-01-30,2022,1,30,348330,343832,4498
2022-01-31,2022,1,31,352811,348330,4481
2022-02-01,2022,2,1,359075,352811,6264
2022-02-02,2022,2,2,362176,359075,3101
2022-02-03,2022,2,3,366473,362176,4297
2022-02-04,2022,2,4,379681,366473,13208
2022-02-05,2022,2,5,379681,379681,0
2022-02-06,2022,2,6,390071,379681,10390
2022-02-07,2022,2,7,405629,390071,15558
2022-02-08,2022,2,8,418640,405629,13011
2022-02-09,2022,2,9,428954,418640,10314
2022-02-10,2022,2,10,439640,428954,10686
2022-02-11,2022,2,11,449570,439640,9930
2022-02-12,2022,2,12,460075,449570,10505
2022-02-13,2022,2,13,469495,460075,9420
2022-02-14,2022,2,14,478577,469495,9082
2022-02-15,2022,2,15,497997,478577,19420
2022-02-16,2022,2,16,514880,497997,16883
2022-02-17,2022,2,17,533425,514880,18545
2022-02-18,2022,2,18,551519,533425,18094
2022-02-19,2022,2,19,576355,551519,24836
2022-02-20,2022,2,20,582638,576355,6283
2022-02-21,2022,2,21,596261,582638,13623
2022-02-22,2022,2,22,622293,596261,26032
2022-02-23,2022,2,23,642605,622293,20312
2022-02-24,2022,2,24,661198,642605,18593
2022-02-25,2022,2,25,679795,661198,18597
2022-02-26,2022,2,26,696652,679795,16857
2022-02-27,2022,2,27,710880,696652,14228
2022-02-28,2022,2,28,724424,710880,13544
2022-03-01,2022,3,1,748504,724424,24080
2022-03-02,2022,3,2,767663,748504,19159
2022-03-03,2022,3,3,785825,767663,18162
2022-03-04,2022,3,4,803389,785825,17564
2022-03-05,2022,3,5,819663,803389,16274
2022-03-06,2022,3,6,832821,819663,13158
2022-03-07,2022,3,7,846341,832821,13520
2022-03-08,2022,3,8,846341,846341,0
2022-03-09,2022,3,9,885593,846341,39252
2022-03-10,2022,3,10,901758,885593,16165
2022-03-11,2022,3,11,917103,901758,15345
2022-03-12,2022,3,12,929735,917103,12632
2022-03-13,2022,3,13,939436,929735,9701
2022-03-14,2022,3,14,948478,939436,9042
2022-03-15,2022,3,15,964329,948478,15851
2022-03-16,2022,3,16,975607,964329,11278
2022-03-17,2022,3,17,986320,975607,10713
2022-03-18,2022,3,18,996914,986320,10594
2022-03-19,2022,3,19,1007158,996914,10244
2022-03-20,2022,3,20,1015017,1007158,7859
2022-03-21,2022,3,21,1022555,1015017,7538
2022-03-22,2022,3,22,1035721,1022555,13166
2022-03-23,2022,3,23,1044661,1035721,8940
2022-03-24,2022,3,24,1053139,1044661,8478
2022-03-25,2022,3,25,1060723,1053139,7584
2022-03-26,2022,3,26,1067157,1060723,6434
2022-03-27,2022,3,27,1067157,1067157,0
2022-03-28,2022,3,28,1072005,1067157,4848
2022-03-29,2022,3,29,1085094,1072005,13089
2022-03-30,2022,3,30,1090823,1085094,5729
2022-03-31,2022,3,31,1096428,1090823,5605
2022-04-01,2022,4,1,1101438,1096428,5010
2022-04-02,2022,4,2,1106001,1101438,4563
2022-04-03,2022,4,3,1109744,1106001,3743
2022-04-04,2022,4,4,1109744,1109744,0
2022-04-05,2022,4,5,1119419,1109744,9675
2022-04-06,2022,4,6,1123886,1119419,4467
2022-04-07,2022,4,7,1128155,1123886,4269
2022-04-08,2022,4,8,1132169,1128155,4014
2022-04-09,2022,4,9,1135428,1132169,3259
2022-04-10,2022,4,10,1138001,1135428,2573
2022-04-11,2022,4,11,1140569,1138001,2568
2022-04-12,2022,4,12,1145121,1140569,4552
2022-04-13,2022,4,13,1148656,1145121,3535
2022-04-14,2022,4,14,1152177,1148656,3521
2022-04-15,2022,4,15,1155581,1152177,3404
2022-04-16,2022,4,16,1157251,1155581,1670
2022-04-17,2022,4,17,1160300,1157251,3049
2022-04-18,2022,4,18,1162780,1160300,2480
2022-04-19,2022,4,19,1167498,1162780,4718
2022-04-20,2022,4,20,1170970,1167498,3472
2022-04-21,2022,4,21,1174390,1170970,3420
2022-04-22,2022,4,22,1177415,1174390,3025
2022-04-23,2022,4,23,1180124,1177415,2709
2022-04-24,2022,4,24,1182168,1180124,2044
2022-04-25,2022,4,25,1184226,1182168,2058
2022-04-26,2022,4,26,1187914,1184226,3688
2022-04-27,2022,4,27,1187914,1187914,0
2022-04-28,2022,4,28,1187914,1187914,0
2022-04-29,2022,4,29,1193250,1187914,5336
2022-04-30,2022,4,30,1193250,1193250,0
2022-05-01,2022,5,1,1193250,1193250,0
2022-05-02,2022,5,2,1200976,1193250,7726
2022-05-03,2022,5,3,1202546,1200976,1570
2022-05-04,2022,5,4,1202546,1202546,0
2022-05-05,2022,5,5,1208917,1202546,6371
2022-05-06,2022,5,6,1212337,1208917,3420
2022-05-07,2022,5,7,1215499,1212337,3162
2022-05-08,2022,5,8,1217922,1215499,2423
2022-05-09,2022,5,9,1220193,1217922,2271
2022-05-10,2022,5,10,1225024,1220193,4831
2022-05-11,2022,5,11,1228914,1225024,3890
2022-05-12,2022,5,12,1232559,1228914,3645
2022-05-13,2022,5,13,1236850,1232559,4291
2022-05-14,2022,5,14,1240233,1236850,3383
2022-05-15,2022,5,15,1242884,1240233,2651
2022-05-16,2022,5,16,1245007,1242884,2123
2022-05-17,2022,5,17,1247671,1245007,2664
2022-05-18,2022,5,18,1254113,1247671,6442
2022-05-19,2022,5,19,1258691,1254113,4578
2022-05-20,2022,5,20,1263033,1258691,4342
2022-05-21,2022,5,21,1266808,1263033,3775
2022-05-22,2022,5,22,1269635,1266808,2827
2022-05-23,2022,5,23,1272386,1269635,2751
2022-05-24,2022,5,24,1278113,1272386,5727
2022-05-25,2022,5,25,1282280,1278113,4167
2022-05-26,2022,5,26,1286216,1282280,3936
2022-05-27,2022,5,27,1290046,1286216,3830
2022-05-28,2022,5,28,1293369,1290046,3323
2022-05-29,2022,5,29,1295920,1293369,2551
2022-05-30,2022,5,30,1298309,1295920,2389
2022-05-31,2022,5,31,1303294,1298309,4985
2022-06-01,2022,6,1,1306871,1303294,3577
2022-06-02,2022,6,2,1310616,1306871,3745
2022-06-03,2022,6,3,1313849,1310616,3233
2022-06-04,2022,6,4,1316728,1313849,2879
2022-06-05,2022,6,5,1318984,1316728,2256
2022-06-06,2022,6,6,1321146,1318984,2162
2022-06-07,2022,6,7,1325623,1321146,4477
2022-06-08,2022,6,8,1329225,1325623,3602
2022-06-09,2022,6,9,1332656,1329225,3431
2022-06-10,2022,6,10,1335625,1332656,2969
2022-06-11,2022,6,11,1338753,1335625,3128
2022-06-12,2022,6,12,1341256,1338753,2503
2022-06-13,2022,6,13,1343645,1341256,2389
2022-06-14,2022,6,14,1348775,1343645,5130
2022-06-15,2022,6,15,1352681,1348775,3906
2022-06-16,2022,6,16,1355801,1352681,3120
2022-06-17,2022,6,17,1360780,1355801,4979
2022-06-18,2022,6,18,1364562,1360780,3782
2022-06-19,2022,6,19,1367761,1364562,3199
2022-06-20,2022,6,20,1370981,1367761,3220
2022-06-21,2022,6,21,1378090,1370981,7109
2022-06-22,2022,6,22,1383952,1378090,5862
2022-06-23,2022,6,23,1390558,1383952,6606
2022-06-24,2022,6,24,1397074,1390558,6516
2022-06-25,2022,6,25,1403242,1397074,6168
2022-06-26,2022,6,26,1408358,1403242,5116
2022-06-27,2022,6,27,1413667,1408358,5309
2022-06-28,2022,6,28,1425171,1413667,11504
2022-06-29,2022,6,29,1434563,1425171,9392
2022-06-30,2022,6,30,1444068,1434563,9505
2022-07-01,2022,7,1,1453155,1444068,9087
2022-07-02,2022,7,2,1461107,1453155,7952
2022-07-03,2022,7,3,1467234,1461107,6127
2022-07-04,2022,7,4,1473180,1467234,5946
2022-07-05,2022,7,5,1485964,1473180,12784
2022-07-06,2022,7,6,1495953,1485964,9989
2022-07-07,2022,7,7,1505938,1495953,9985
2022-07-08,2022,7,8,1515222,1505938,9284
2022-07-09,2022,7,9,1523881,1515222,8659
2022-07-10,2022,7,10,1530304,1523881,6423
2022-07-11,2022,7,11,1534799,1530304,4495
2022-07-12,2022,7,12,1540778,1534799,5979
2022-07-13,2022,7,13,1557648,1540778,16870
2022-07-14,2022,7,14,1569420,1557648,11772
2022-07-15,2022,7,15,1579946,1569420,10526
2022-07-16,2022,7,16,1589099,1579946,9153
2022-07-17,2022,7,17,1596046,1589099,6947
2022-07-18,2022,7,18,1602273,1596046,6227
2022-07-19,2022,7,19,1616067,1602273,13794
2022-07-20,2022,7,20,1626360,1616067,10293
2022-07-21,2022,7,21,1636109,1626360,9749
2022-07-22,2022,7,22,1645092,1636109,8983
2022-07-23,2022,7,23,1652981,1645092,7889
2022-07-24,2022,7,24,1659156,1652981,6175
2022-07-25,2022,7,25,1664707,1659156,5551
2022-07-26,2022,7,26,1677126,1664707,12419
2022-07-27,2022,7,27,1685889,1677126,8763
2022-07-28,2022,7,28,1694454,1685889,8565
2022-07-29,2022,7,29,1702392,1694454,7938
2022-07-30,2022,7,30,1708950,1702392,6558
2022-07-31,2022,7,31,1714056,1708950,5106
2022-08-01,2022,8,1,1718765,1714056,4709
2022-08-02,2022,8,2,1728995,1718765,10230
2022-08-03,2022,8,3,1728995,1728995,0
2022-08-04,2022,8,4,1742874,1728995,13879
2022-08-05,2022,8,5,1749144,1742874,6270
2022-08-06,2022,8,6,1754777,1749144,5633
2022-08-07,2022,8,7,1759575,1754777,4798
2022-08-08,2022,8,8,1763116,1759575,3541
2022-08-09,2022,8,9,1771081,1763116,7965
2022-08-10,2022,8,10,1773386,1771081,2305
2022-08-11,2022,8,11,1773386,1773386,0
2022-08-12,2022,8,12,1786643,1773386,13257
2022-08-13,2022,8,13,1791046,1786643,4403
2022-08-14,2022,8,14,1794069,1791046,3023
2022-08-15,2022,8,15,1794069,1794069,0
2022-08-16,2022,8,16,1801936,1794069,7867
2022-08-17,2022,8,17,1805698,1801936,3762
2022-08-18,2022,8,18,1809251,1805698,3553
2022-08-19,2022,8,19,1812255,1809251,3004
2022-08-20,2022,8,20,1814915,1812255,2660
2022-08-21,2022,8,21,1816866,1814915,1951
2022-08-22,2022,8,22,1818560,1816866,1694
2022-08-23,2022,8,23,1822187,1818560,3627
2022-08-24,2022,8,24,1824832,1822187,2645
2022-08-25,2022,8,25,1827229,1824832,2397
2022-08-26,2022,8,26,1829361,1827229,2132
2022-08-27,2022,8,27,1831332,1829361,1971
2022-08-28,2022,8,28,1832780,1831332,1448
2022-08-29,2022,8,29,1834190,1832780,1410
2022-08-30,2022,8,30,1837090,1834190,2900
2022-08-31,2022,8,31,1839244,1837090,2154
2022-09-01,2022,9,1,1841288,1839244,2044
2022-09-02,2022,9,2,1843236,1841288,1948
2022-09-03,2022,9,3,1844785,1843236,1549
2022-09-04,2022,9,4,1846094,1844785,1309
2022-09-05,2022,9,5,1847270,1846094,1176
2022-09-06,2022,9,6,1850015,1847270,2745
2022-09-07,2022,9,7,1852286,1850015,2271
2022-09-08,2022,9,8,1854455,1852286,2169
2022-09-09,2022,9,9,1856673,1854455,2218
2022-09-10,2022,9,10,1858497,1856673,1824
2022-09-11,2022,9,11,1859937,1858497,1440
2022-09-12,2022,9,12,1861390,1859937,1453
2022-09-13,2022,9,13,1864742,1861390,3352
2022-09-14,2022,9,14,1867168,1864742,2426
2022-09-15,2022,9,15,1869591,1867168,2423
2022-09-16,2022,9,16,1871900,1869591,2309
2022-09-17,2022,9,17,1873747,1871900,1847
2022-09-18,2022,9,18,1875275,1873747,1528
2022-09-19,2022,9,19,1876584,1875275,1309
2022-09-20,2022,9,20,1879806,1876584,3222
2022-09-21,2022,9,21,1882314,1879806,2508
2022-09-22,2022,9,22,1884859,1882314,2545
2022-09-23,2022,9,23,1887202,1884859,2343
2022-09-24,2022,9,24,1889544,1887202,2342
2022-09-25,2022,9,25,1891341,1889544,1797
2022-09-26,2022,9,26,1892947,1891341,1606
2022-09-27,2022,9,27,1897307,1892947,4360
2022-09-28,2022,9,28,1900761,1897307,3454
2022-09-29,2022,9,29,1904192,1900761,3431
2022-09-30,2022,9,30,1907907,1904192,3715
2022-10-01,2022,10,1,1911417,1907907,3510
2022-10-02,2022,10,2,1914280,1911417,2863
2022-10-03,2022,10,3,1916993,1914280,2713
2022-10-04,2022,10,4,1924139,1916993,7146
2022-10-05,2022,10,5,1930062,1924139,5923
2022-10-06,2022,10,6,1936270,1930062,6208
2022-10-07,2022,10,7,1942204,1936270,5934
2022-10-08,2022,10,8,1948402,1942204,6198
2022-10-09,2022,10,9,1953197,1948402,4795
2022-10-10,2022,10,10,1957916,1953197,4719
2022-10-11,2022,10,11,1969648,1957916,11732
2022-10-12,2022,10,12,1979259,1969648,9611
2022-10-13,2022,10,13,1988760,1979259,9501
2022-10-14,2022,10,14,1997847,1988760,9087
2022-10-15,2022,10,15,2005884,1997847,8037
2022-10-16,2022,10,16,2012065,2005884,6181
2022-10-17,2022,10,17,2017261,2012065,5196
2022-10-18,2022,10,18,2029195,2017261,11934
2022-10-19,2022,10,19,2037947,2029195,8752
2022-10-20,2022,10,20,2046123,2037947,8176
2022-10-21,2022,10,21,2053370,2046123,7247
2022-10-22,2022,10,22,2059709,2053370,6339
2022-10-23,2022,10,23,2064163,2059709,4454
2022-10-24,2022,10,24,2067790,2064163,3627
2022-10-25,2022,10,25,2070784,2067790,2994
2022-10-26,2022,10,26,2080341,2070784,9557
2022-10-27,2022,10,27,2086588,2080341,6247
2022-10-28,2022,10,28,2091889,2086588,5301
2022-10-29,2022,10,29,2096520,2091889,4631
2022-10-30,2022,10,30,2099760,2096520,3240
2022-10-31,2022,10,31,2102372,2099760,2612
2022-11-01,2022,11,1,2108024,2102372,5652
2022-11-02,2022,11,2,2112110,2108024,4086
2022-11-03,2022,11,3,2115621,2112110,3511
2022-11-04,2022,11,4,2118749,2115621,3128
2022-11-05,2022,11,5,2121435,2118749,2686
2022-11-06,2022,11,6,2123328,2121435,1893
2022-11-07,2022,11,7,2125004,2123328,1676
2022-11-08,2022,11,8,2128572,2125004,3568
2022-11-09,2022,11,9,2131554,2128572,2982
2022-11-10,2022,11,10,2134319,2131554,2765
2022-11-11,2022,11,11,2136658,2134319,2339
2022-11-12,2022,11,12,2138598,2136658,1940
2022-11-13,2022,11,13,2140099,2138598,1501
2022-11-14,2022,11,14,2141411,2140099,1312
2022-11-15,2022,11,15,2144522,2141411,3111
2022-11-16,2022,11,16,2146706,2144522,2184
2022-11-17,2022,11,17,2148794,2146706,2088
2022-11-18,2022,11,18,2150702,2148794,1908
2022-11-19,2022,11,19,2152368,2150702,1666
2022-11-20,2022,11,20,2153535,2152368,1167
2022-11-21,2022,11,21,2154633,2153535,1098
2022-11-22,2022,11,22,2157021,2154633,2388
2022-11-23,2022,11,23,2158709,2157021,1688
2022-11-24,2022,11,24,2160324,2158709,1615
2022-11-25,2022,11,25,2161673,2160324,1349
2022-11-26,2022,11,26,2162963,2161673,1290
2022-11-27,2022,11,27,2163872,2162963,909
2022-11-28,2022,11,28,2164689,2163872,817
2022-11-29,2022,11,29,2166527,2164689,1838
2022-11-30,2022,11,30,2167897,2166527,1370
2022-12-01,2022,12,1,2169201,2167897,1304
2022-12-02,2022,12,2,2170498,2169201,1297
2022-12-03,2022,12,3,2171550,2170498,1052
2022-12-04,2022,12,4,2172396,2171550,846
2022-12-05,2022,12,5,2173172,2172396,776
2022-12-06,2022,12,6,2174989,2173172,1817
2022-12-07,2022,12,7,2176338,2174989,1349
2022-12-08,2022,12,8,2177701,2176338,1363
